 XXXXX        
 X   XXXXXXX  
 X * XXX   X  
 X *    ** X  
 XX XXXX   X  
XXX X  X XXX  
X   X  X@XX   
X **    * X   
X   X X * XXXX
XXXXX X   X  X
 X   *XXXX   X
 X  *     *  X
 XX   XXXXX XX
 XXXXXXXXXX  X
XX....X *  * X
X.....X **X  X
X.. ..X *  * X
X.....*   X  X
XX  XXXXXXXXXX
 XXXX
