       XXXX      
    XXXX  X      
   XX  X  X      
   X  * * X      
 XXX X*   XXXX   
 X  *  XX*   X   
 X  X @ * X *X   
 X  X      * XXXX
 XX XXXX*XX     X
 X *X.....X X   X
 X  *...&. *X XXX
XX  X.....X   X  
X   XXX XXXXXXX  
X **  X  X       
X  X     X       
XXXXXX   X       
     XXXXX
