              XXXX   
         XXXXXX  X   
         X       X   
         X  XXXX XXX 
 XXX  XXXXX XXX    X 
XX@XXXX   *** X    X 
X **   ** *   X....XX
X  ***X    *  X.....X
X *   X ** ** X.....X
XXX   X  *    X.....X
  X   X * * * X.....X
  X XXXXXXX XXX.....X
  X   X  * *  X.....X
  XXX X ** * *XXXXXXX
    X X  *      X    
    X X *** *** X    
    X X       X X    
    X XXXXXXXXX X    
    X           X    
    XXXXXXXXXXXXX    
