          XXXXXXX
          X  ...X
      XXXXX  ...X
      X      ...X
      X  XX  ...X
      XX XX  ...X
     XXX XXXXXXXX
     X *** XX    
 XXXXX  * * XXXXX
XX   X* *   X   X
X@ *  *    *  * X
XXXXXX ** * XXXXX
     X *    X    
     XXXX XXX    
        X  X     
        X  X     
        X  X     
        XXXX     
