       XXXXXXX           
       X  X  XXXX        
       X *X* X  XX       
XXXXXXXX  X  X   XXXXXXXX
X....  X *X* X  *X  X   X
X....X X     X*  X      X
X..X.    *X  X *    X*  X
X... @XX  X* X*  X  X   X
X.... XX *X     *XXXXXXXX
XXXXXXXX  X**X*  X       
       X *X  X  *X       
       X  X  X   X       
       XXXX  XXXXX       
          XXXX
