XXXXXX  XXX 
X..  X XX@XX
X..  XXX   X
X..     ** X
X..  X X * X
X..XXX X * X
XXXX * X*  X
   X  *X * X
   X *  *  X
   X  XX   X
   XXXXXXXXX
